####################
##       #         #
#O# #### # ####### #
#      #   #     ###
## ## ###### ### ###
#  ## #      # # ###
##### ## #####   ###
#      # ##  # # ###
# ######    #### ###
# # #    ####    ###
#     #### ## ######
# ######## ##     ##
##### #       ### ##
#     # #########  #
# ##### ####    ## #
#     # #### ## ####
# ### #      ##   ##
# # # ######### # ##
# #             # ##
# ##################